NO ./texture.xpm
SO ./texture.xpm
WE ./texture.xpm
EA ./texture.xpm
F 0,100,0


C 225,30,0

11111111111111111111111111111
11110000000000011101010010001
11000000000000000000000010001
11000000000000000000000010001
11000000000000000000000010001
11000000000000000000000010001
11000000000000000000000010001
11000000000000000000000010001
11000000000000000000000010001
11000000000000000000000010001
11000000000000000000000010001
10000000000000000000000010001
10000000000N00000001010010001
11111111111111111111111111111
