NO ./Textures/mur_NO.xpm
SO ./Textures/mur_SO.xpm
EA ./Textures/mur_EA.xpm
WE ./Textures/mur_WE.xpm



C 3, 227, 252
F 26, 10, 111

    1111111111111111111111111
    1000000000110000000000001
11111011000001110000000000001
10010000000000000000000011111
11111111101100000111000001
110011111111111111111111111111
  100000000000000011101111
1111011111111101000000001
11110111111111011101010001
1100000011010101110000001

100000000100100001100000111
1000E0000000000011110100101
110000011101010111110111111
11110111  110101 10111101
11111111  111111 11111111